###########################
#                        O#
### ##### ########### ## ##
### ##### ######## ## ##  #
### ###   ########     # ##
### ##### ######## ##### ##
### #####  #######   # # ##
########  ###   ###### # ##
### #######   #      # # ##
#           ### ###### # ##
#X### #######            ##
###########################