###########################
# +++++++++++++++++++++++O#
##+########################
#++           #        # ##
#+            #        # ##
#+            #        # ##
#+            #        # ##
#+            #        # ##
#+#########   #        # ##
#+         ## # ###### # ##
#X###########            ##
###########################
