###########################
#                       +O#
### ##### ########### ##+##
### ##### ######## ## ##+ #
### ###   ########     #+##
### ##### ######## #####+##
### #####  #######   # #+##
########  ###+++###### #+##
### #######+++#+     # #+##
#+++++++++++###+###### #+##
#X### #######  ++++++++++##
###########################
